1,0,1,1,1,0,1,0,1,0,1,1,1,0,1,1,2,1,0,1
0,1,1,1,1,1,0,0,0,1,0,1,0,1,2,1,2,0,2,0
0,1,0,1,0,1,1,0,1,1,0,1,0,0,0,0,0,0,0,0
0,1,0,1,1,0,0,0,1,0,0,0,0,0,0,0,0,0,0,2
1,0,1,0,1,0,1,1,2,0,0,0,0,0,2,0,0,0,0,0
1,1,1,0,1,2,1,0,0,0,0,0,0,0,0,0,0,0,0,1
1,1,0,1,0,0,0,0,0,0,0,0,0,0,0,0,0,0,0,0
1,0,1,2,0,0,0,1,0,0,0,0,0,0,0,0,0,0,0,0
1,1,0,0,0,1,0,0,0,0,0,0,0,0,0,0,0,0,0,1
2,2,0,0,0,0,3,0,0,0,0,0,0,0,0,0,0,0,0,0
0,1,0,2,0,2,0,0,0,0,0,0,0,0,0,0,0,0,0,0
1,0,0,0,0,0,0,0,0,2,0,0,0,3,0,1,0,0,0,0
0,7
vache=8,15,10,15,10,17,9,17,9,16,8,16
solution=1,0,0,-1,1,0,0,-1,1,0,-1,0,0,1,-1,0,0,1,1,0,0,-1,-1,0,0,1,-1,0,0,-1,-1,0,1,0,0,1,-1,0,0,-1,0,1,1,0,0,1,-1,0
