0,0,0,0,0,0,1,0,0,0,0,0,0,0,0,1,0,0,0,0
0,0,0,0,0,0,0,0,0,0,0,0,0,0,0,0,0,0,0,0
0,0,1,1,1,1,1,1,1,1,1,1,1,1,1,1,1,1,0,0
0,1,0,0,0,0,0,0,2,0,0,0,0,0,0,0,0,2,1,0
0,0,0,0,1,1,0,0,2,0,0,0,0,0,0,0,0,0,0,0
0,1,0,1,0,0,2,2,2,2,2,0,0,0,0,0,0,0,1,0
0,0,0,0,1,1,0,0,2,0,0,0,0,0,0,0,0,0,0,0
0,1,0,0,0,0,0,0,2,0,0,0,0,0,0,0,0,2,1,0
0,0,1,1,1,1,1,1,1,1,1,1,1,1,1,1,1,1,0,0
0,0,0,0,0,0,0,0,0,0,0,0,0,0,0,0,0,0,0,0
0,0,0,0,0,0,0,0,0,0,0,0,0,0,0,0,0,0,0,0
0,0,0,0,0,0,1,0,0,0,0,0,0,0,0,1,0,0,0,0
5,4
vache=5,11,5,6,5,7,3,7,7,7,5,7
