1,0,0,0,0,1,0,1,0,0,1,0,0,1,0,0,0,0,0,1
0,0,1,0,0,0,0,2,0,0,0,0,0,3,0,0,0,0,0,0
0,0,0,11,0,1,1,1,1,1,0,1,1,1,1,1,1,1,0,1
0,1,0,0,1,0,0,0,0,1,2,1,1,2,2,0,2,0,0,10
0,0,0,0,1,0,0,0,1,1,0,1,1,1,1,1,1,1,0,0
1,1,1,1,1,0,0,0,2,0,0,0,3,1,0,0,0,0,1,1
0,0,0,2,0,3,0,0,1,1,0,1,2,0,0,0,0,1,3,3
0,0,0,3,0,3,0,0,0,1,2,1,4,0,0,0,0,0,0,0
2,2,2,11,3,3,3,3,1,0,0,0,1,0,0,0,0,0,0,4
0,0,0,2,0,0,0,1,0,0,2,0,0,1,0,0,0,0,0,0
0,0,0,2,0,0,1,0,0,2,0,2,0,0,1,0,0,0,0,1
4,0,0,2,0,1,2,2,2,0,3,0,2,2,2,1,0,10,2,0
5,10
vache=3,13,3,18,4,18,3,18
chat=5,14,9,14
chat=5,15,10,15
chat=5,16,11,16
chat=10,7,8,9,8,11,10,13,8,11,8,9
sol_temp=0,1,3,1,0,0,0,1,0,1,0,0,-1,0,0,0,-1,0,1,0,0,0,-1,116,-1,0,0,0,0,136,-1,0,160,0,-1,0,1,0,0,-1,0,0,0,-1,0,1,0,0,0,-1,0,1,0,0,0,1,0,-1,0,0,0,1,0,1,0,0,0,-1,0,0,1,0,0,-1,0,1,0,0,-1,0,0,0,1,0,1,0,0,0,1,0,0,-1,0,-1,0,0,0,-1,0,1,0,0,0,1,0,-1,0,0,0,0,0,-1,0,354,0,-1,0,-1,0,0,1,0,379,0,1,0,0,-1,0,-1,0,444,0,-1,0,1,0,0,0,-1,0
