0,1,0,0,0,0,0,0,0,0,2,0,1,1,1,0,1,1,1,0
0,1,0,1,0,0,0,0,0,0,0,0,1,0,1,0,1,0,1,0
0,1,0,0,0,0,1,1,1,1,2,1,1,2,1,1,1,3,1,1
0,1,1,0,0,0,0,0,0,0,0,0,0,0,0,0,0,0,0,0
0,1,0,0,0,0,0,0,0,0,0,0,0,0,0,0,0,0,0,0
0,1,0,0,0,0,0,0,0,0,2,0,0,1,0,2,0,0,0,0
0,1,0,0,0,0,0,0,0,0,0,0,0,0,0,2,0,0,0,0
0,1,0,0,0,2,2,2,2,0,0,0,0,0,0,0,2,2,0,0
0,1,0,0,1,0,0,0,0,0,0,0,0,0,0,0,0,0,0,0
0,1,0,0,0,0,0,0,0,0,0,0,0,0,0,0,0,0,0,0
0,1,1,1,1,1,1,1,1,1,1,1,1,1,1,1,1,1,1,1
0,0,0,0,0,0,0,0,0,0,0,0,0,0,0,0,0,0,0,0
1,13
vache=6,12,4,12,4,14,6,14
vache=6,16,3,16,3,15,6,15
vache=8,16,8,19,7,19,7,9,8,9,8,12,7,12,7,16
