0,0,0,0,0,0,0,0,10,0,0,0,0,0,0,0,0,0,1,0
0,0,0,0,12,0,0,11,0,0,1,0,0,0,0,2,0,0,0,0
0,0,0,0,0,0,0,0,0,0,0,0,0,0,0,0,0,0,0,0
0,0,0,0,0,0,0,0,0,0,0,2,0,0,0,0,0,0,0,0
0,0,0,0,0,0,0,1,2,0,2,0,0,0,0,0,0,0,2,1
0,0,0,0,0,0,2,0,0,2,3,1,0,0,0,0,0,0,0,0
0,0,0,0,0,0,1,0,0,0,0,0,0,0,0,0,0,0,0,0
1,0,2,12,2,2,0,2,0,0,0,0,0,0,1,0,0,0,0,0
0,0,0,0,0,0,0,0,1,0,0,0,0,0,0,0,0,0,0,0
0,0,0,0,0,0,0,0,0,0,1,0,0,0,2,0,0,0,0,2
0,0,0,0,0,0,0,1,0,0,0,0,0,0,0,0,0,0,0,0
0,0,0,10,0,0,0,0,0,0,0,0,0,0,0,0,0,0,0,11
9,11
vache=1,1,1,4,3,4,3,1
vache=11,16,11,19,11,13,11,16,5,16,5,19,11,19
chat=10,8,10,19
sol_temp=0,1,4,0,1,0,0,-1,0,-1,0,0,0,-1,0,-1,0,0,0,-1,0,0,1,0,-1,0,0,1,0,0,0,1,0,-1,0,0,0,-1,0,1,0,0,0,-1,0,1,0,0,0,-1,192,0,-1,236
