1,1,1,1,1,1,1,1,1,1,1,1,1,1,1,1,1,1,1,1
1,0,0,0,0,0,0,0,0,0,0,0,0,0,0,0,1,2,4,1
1,0,0,0,0,0,2,0,0,0,0,0,0,0,2,0,1,2,2,1
1,0,0,0,0,0,0,0,0,0,0,0,0,0,0,0,1,1,1,1
1,1,0,0,0,0,0,0,0,0,0,0,0,1,0,0,0,0,0,1
1,0,0,0,2,3,2,0,0,1,0,0,3,0,0,0,0,0,0,1
1,1,0,0,0,0,0,0,0,0,3,10,2,2,4,2,2,10,0,1
1,0,0,0,0,0,0,0,0,0,0,0,0,0,0,0,0,0,0,1
1,0,0,0,0,0,2,0,0,0,0,0,0,3,0,0,1,1,1,1
1,0,0,0,0,0,0,0,0,0,3,0,0,0,1,0,1,2,2,1
1,0,0,0,0,0,1,0,0,0,0,0,0,0,0,0,1,2,0,1
1,1,1,1,1,1,1,1,1,1,1,1,1,1,1,1,1,1,1,1
5,1
vache=4,14,8,14,8,15,4,15
chat=4,2,4,9
chat=6,9,6,2
sol_temp=0,1,4,0,-1,0,-1,0,0,1,0,0,0,1,0,-1,0,0,0,-1,0,1,0,0,0,1,0,-1,0,0,0,1,0,-1,0,0,0,1,0,1,0,0,0,1,0,-1,0,0,0,0,0,-1,0,183,0,-1,0,1,0,0,0,1,0,1,0,0,0,0,210,1,0,234,0,-1,0,-1,0,0
h_param=4
