0,0,0,0,0,0,1,1,0,0,0,0,0,1,1,0,0,0,0,0
0,0,0,0,0,1,0,0,1,0,0,0,1,2,0,1,0,0,0,0
0,0,0,0,1,0,0,0,0,1,0,1,0,0,0,0,1,0,0,0
0,0,0,0,1,0,0,0,0,4,1,0,0,0,0,0,1,0,0,0
0,0,0,0,1,11,2,0,0,0,1,0,0,0,2,0,1,0,0,0
0,0,0,0,1,0,0,0,0,0,0,0,0,0,0,0,1,0,0,0
0,0,0,0,0,1,0,2,0,0,0,0,0,0,0,1,0,0,0,0
0,0,0,0,0,0,1,0,0,0,3,0,4,0,1,0,0,0,0,0
0,0,0,0,0,0,0,1,0,0,11,0,0,1,0,0,0,0,0,0
0,0,0,0,0,0,0,0,1,0,0,3,1,0,0,0,0,0,0,0
0,0,0,0,0,0,0,0,0,1,2,1,0,0,0,0,0,0,0,0
0,0,0,0,0,0,0,0,0,0,1,0,0,0,0,0,0,0,0,0
6,12
vache=2,5,2,8,2,7,5,7,5,5
chat=3,11,8,11,8,9,3,9,8,9,8,11
solution=0,1,0,-1,0,1,1,0,0,1
