0,0,0,0,0,0,0,0,1,1,1,1,0,0,0,0,2,0,0,0
0,0,0,0,0,0,0,1,2,0,0,2,1,0,0,0,0,2,0,0
0,2,0,0,0,0,0,1,0,0,0,0,1,0,0,0,0,0,0,0
0,0,0,0,1,1,1,0,0,0,0,0,0,1,1,1,2,0,0,0
0,0,0,1,0,0,0,0,0,0,0,4,0,0,0,0,1,0,3,0
1,3,0,1,0,0,0,2,0,0,0,0,0,0,0,0,1,0,0,0
0,0,1,0,0,0,0,0,0,0,0,0,0,0,0,0,0,1,0,0
10,0,1,0,0,0,0,0,0,0,0,0,0,0,0,0,0,1,0,0
1,1,0,0,0,0,0,2,0,0,0,0,0,0,0,0,0,0,1,1
0,0,0,0,0,0,0,0,0,0,0,0,2,0,0,0,0,0,0,0
0,0,10,0,0,0,0,0,0,0,0,0,0,0,0,0,0,0,0,0
0,0,0,0,0,0,0,0,0,0,0,1,0,0,0,0,0,0,3,0
7,7
chat=0,0,0,6,1,6,1,4,2,4,2,2,4,2,4,0
sol_temp=1,0,3,-1,0,0,0,1,0,1,0,0,0,1,0,-1,0,0,0,-1,0,1,0,0,0,1,0,-1,0,0,0,1,0,1,0,0,-1,0,0,0,0,0,0,-1,0,0,1,170,-1,0,0,0,1,0,1,0,0,0,-1,0,-1,0,0,1,0,0,0,-1,0,-1,0,0,0,1,0,1,0,0,0,-1,0,-1,0,0,0,-1,0,-1,0,0,0,-1,0,1,0,0,0,-1,0,0,1,0,-1,0,0,
