0,0,0,0,0,0,0,0,0,0,0,0,0,0,0,0,0,0,0,0
0,0,0,0,0,0,0,0,0,0,0,0,0,0,0,0,0,0,0,0
0,0,0,0,0,0,0,1,1,1,0,0,0,0,0,0,0,0,0,0
0,0,0,0,0,0,1,0,0,0,3,0,0,0,0,0,0,0,0,0
0,0,0,0,0,1,2,0,0,0,0,1,1,1,1,0,0,0,0,0
0,0,0,0,0,1,0,2,1,0,0,1,1,0,0,0,0,0,0,0
0,0,0,0,0,1,0,0,0,0,3,1,0,1,0,0,0,0,0,0
0,0,0,2,0,0,1,0,0,2,0,1,0,0,1,0,0,0,0,0
0,0,0,0,0,0,0,1,0,0,1,0,0,0,0,0,0,0,0,0
0,0,0,0,0,1,1,0,0,0,0,1,0,0,0,0,0,0,0,0
0,0,0,1,1,4,0,0,0,0,0,0,1,0,0,0,0,0,0,0
0,1,1,2,2,2,2,2,2,2,2,2,3,1,0,0,0,0,0,0
4,1
vache=5,16,5,19,0,19,0,15,1,15,1,16
