0,0,1,0,0,0,0,0,0,0,0,1,0,0,0,0,0,1,0,0
0,0,2,0,4,0,0,0,0,2,0,2,1,0,0,0,0,2,0,0
0,0,0,0,0,0,0,0,0,0,0,0,0,1,0,0,0,0,0,0
0,0,0,0,1,0,0,2,0,0,0,0,2,0,0,0,3,0,0,0
0,0,0,0,0,0,0,0,0,0,0,2,0,0,0,0,0,0,0,0
0,0,2,0,0,0,0,0,0,0,0,0,0,0,0,2,0,2,0,0
0,0,0,0,0,0,0,0,0,0,0,1,0,0,0,0,0,0,1,0
0,0,0,0,0,0,0,1,0,0,0,2,0,0,0,0,0,0,0,0
0,1,0,2,0,0,2,0,0,0,0,3,0,0,0,0,2,0,0,0
0,0,0,0,1,0,0,0,3,0,2,3,0,0,0,0,0,0,0,0
0,0,0,0,0,0,0,0,0,0,0,0,0,0,0,0,0,0,0,0
0,0,0,0,0,0,0,0,0,0,0,0,0,0,0,0,0,0,0,0
2,15
vache=7,14,7,17,10,17,10,14
sol_temp=1,0,3,-1,0,0,0,1,0,-1,0,0,0,1,0,1,0,0,0,1,0,-1,0,46,1,0,84,0,-1,0,-1,0,0,0,1,0,1,0,0,0,0,0,1,0,179,0,1,228,-1,0,0,0,-1,0,0,1,0,1,0,388,0,-1,0
