0,0,0,0,0,3,0,0,0,0,0,0,0,0,0,0,0,0,2,0
0,2,0,0,0,0,3,0,0,4,0,0,2,0,0,0,0,0,2,0
0,0,0,0,0,0,0,0,0,0,0,0,0,0,0,0,0,0,0,0
0,0,2,0,0,1,1,2,4,4,4,2,1,1,0,0,2,0,0,0
0,0,0,0,0,1,0,1,0,0,0,1,0,1,0,0,0,0,0,0
0,0,0,0,0,1,2,0,1,0,1,0,2,1,0,0,0,0,0,0
0,0,0,0,0,1,0,0,0,3,0,0,0,1,0,0,0,0,0,0
0,0,0,0,0,1,2,0,2,0,2,0,2,1,0,0,0,0,0,0
0,0,0,0,0,1,0,0,0,0,0,0,0,1,0,0,0,0,0,0
0,0,0,0,0,0,0,2,0,0,0,2,0,0,0,0,0,0,0,0
0,0,0,0,0,0,0,0,0,0,0,0,0,0,0,0,0,0,0,0
0,0,0,0,0,0,0,0,0,3,0,0,0,0,0,0,0,0,0,0
1,0
chat=0,9,5,9
vache=10,5,10,13
sol_temp=0,1,3,0,-1,46,1,0,0,0,1,86,0,0,101,0,1,125,0,0,0,0,1,154,0,-1,0,0,0,0,0,-1,210,0,0,0,0,-1,239,-1,0,270,0,1,0,1,0,0,0,-1,0,0,1,0,-1,0,0,0,-1,0,-1,0,0,1,0,0,0,1,0,-1,0,0,0,1,0,-1,0,0,1,0,0,0,-1,0,-1,0,0,0,1,0,1,0,461,0,-1,471
