0,0,0,0,0,0,0,0,4,0,0,0,0,1,0,0,0,0,0,0
0,0,0,1,1,1,0,0,0,0,0,0,0,0,0,0,0,0,0,0
0,0,1,2,0,0,3,0,0,0,0,0,0,0,0,0,0,0,0,0
0,0,1,0,0,2,1,1,1,1,1,1,3,1,3,3,0,0,0,0
0,0,1,2,0,0,1,12,0,0,0,0,0,0,0,11,1,0,0,1
0,0,0,1,1,1,10,0,0,0,0,0,0,0,0,0,3,0,0,0
0,0,1,0,0,0,1,11,0,0,0,0,0,0,0,10,1,0,0,0
0,0,1,2,0,2,3,1,1,1,1,1,3,1,1,1,0,0,0,0
0,0,1,0,2,0,3,0,0,0,0,0,0,0,0,0,0,0,0,0
0,0,0,1,1,1,0,0,0,0,0,0,0,0,0,0,0,0,0,0
0,0,0,0,0,0,0,0,0,0,0,0,0,1,1,1,1,1,1,1
0,0,0,0,0,0,0,0,0,0,0,0,1,1,2,3,2,3,0,12
8,18
