0,0,1,0,0,0,0,1,1,0,1,0,0,0,0,0,12,0,0,0
1,0,0,0,1,0,0,1,1,0,0,0,1,0,0,0,0,0,0,0
0,0,0,10,0,0,1,1,0,0,0,0,0,11,0,3,0,2,2,0
0,0,1,0,0,0,0,1,1,0,0,0,0,0,0,0,0,0,0,1
0,0,0,0,0,0,0,1,0,0,0,0,0,0,0,0,12,1,0,0
0,0,0,1,0,0,0,1,0,0,0,0,0,0,0,0,1,0,1,0
1,1,1,1,1,1,1,0,0,0,0,0,1,1,1,1,1,1,1,1
1,0,1,0,0,0,0,0,1,0,0,1,0,0,0,2,0,0,0,1
0,0,0,0,0,1,1,0,0,0,1,1,0,0,0,2,0,0,0,2
1,0,1,1,0,0,0,0,1,0,0,1,0,2,2,10,2,2,11,2
0,0,0,0,0,0,1,0,0,0,1,1,0,0,0,2,0,0,0,2
0,1,1,0,0,1,0,0,1,0,1,1,0,0,0,2,0,0,0,1
4,5
vache=3,11,5,11
chat=4,8,5,8,5,10,4,10
