0,0,0,0,0,0,0,0,0,0,0,0,0,0,2,0,2,2,0,0
0,0,0,0,0,0,0,0,0,0,0,0,0,0,0,0,0,0,0,0
0,0,0,1,0,0,0,0,2,0,2,0,0,2,0,0,0,0,0,0
0,0,1,0,0,0,0,0,0,0,0,0,0,0,0,0,0,0,0,0
1,1,0,0,0,0,0,0,0,1,0,0,0,0,0,0,0,0,0,0
1,0,4,4,4,4,0,3,3,3,3,0,0,1,1,0,0,0,0,0
1,1,0,0,0,0,0,0,1,0,1,0,0,0,0,0,0,0,0,0
0,0,1,0,0,0,0,0,0,0,0,0,0,0,0,0,0,0,0,0
0,0,0,1,0,0,0,0,0,0,0,0,0,0,0,0,0,0,0,0
0,0,0,0,0,0,0,0,0,2,0,0,0,2,0,0,0,0,0,0
0,0,0,0,0,0,0,0,0,0,0,0,0,0,0,0,0,0,0,0
0,0,0,0,0,0,0,0,0,0,0,0,0,0,2,0,2,2,0,0
5,1
sol_temp=0,1,5,0,0,0,0,-1,0,0,0,32,0,-1,56,0,0,0,-1,0,66,1,0,0,0,-1,0,0,0,93,1,0,100,-1,0,0,0,-1,0,-1,0,0,1,0,0,0,1,0,-1,0,0,1,0,0,0,1,0,-1,0,0,0,-1,0
h_fleur=9,9,100,2,8,200,2,10,100
h_param=0
