0,0,0,0,0,0,2,0,1,0,0,0,0,0,0,2,0,0,0,0
0,0,0,0,0,0,0,0,0,0,0,0,0,0,0,0,0,0,0,0
0,0,0,0,0,0,0,0,0,0,10,0,0,0,0,0,0,0,0,0
2,1,0,11,0,0,1,0,0,1,2,1,0,1,1,0,12,0,1,2
0,1,0,0,0,1,12,1,0,1,2,1,0,1,0,1,0,1,0,1
0,1,0,0,0,1,2,1,0,1,2,1,0,1,0,1,0,1,2,1
0,1,0,0,0,1,3,1,0,1,2,1,0,1,1,0,0,1,3,1
0,1,0,10,0,1,0,1,0,1,2,1,0,1,0,1,0,1,0,1
0,1,1,1,2,1,0,1,0,0,3,0,0,1,0,1,0,1,0,1
0,0,0,0,0,0,0,0,0,0,0,0,0,0,0,0,0,0,0,0
2,0,0,0,0,0,2,0,0,1,0,0,0,0,0,0,0,0,0,0
0,2,0,0,0,1,11,0,0,0,0,0,2,0,0,0,0,0,3,0
4,18
chat=2,8,2,12,9,12,9,8
chat=9,12,9,8,2,8,2,12
