1,1,1,1,1,1,1,1,1,1,1,1,1,1,1,1,0,1,1,1
1,1,2,0,0,0,0,0,0,0,0,0,0,0,0,0,0,0,2,1
1,0,10,1,0,0,0,0,0,0,0,0,2,11,0,0,0,1,0,1
1,3,2,0,0,0,0,0,0,0,0,0,0,10,0,3,0,1,0,1
1,2,0,0,0,0,0,0,0,0,0,0,0,0,0,0,0,3,0,1
1,1,0,0,0,0,0,0,0,0,0,0,0,0,0,0,0,0,0,1
1,12,1,0,0,0,0,0,0,0,0,0,0,0,0,11,0,0,0,1
1,3,0,0,0,0,0,0,0,0,0,0,0,3,0,0,0,0,0,1
1,0,0,0,0,0,0,0,0,0,0,0,0,0,2,0,0,0,1,1
1,0,0,0,0,0,0,0,0,0,0,0,1,0,0,0,0,0,2,1
1,0,0,0,0,0,0,0,0,0,2,0,0,0,0,0,0,0,0,1
1,1,1,1,1,1,1,1,1,1,1,1,1,12,1,1,0,1,1,1
2,1
solution=1,0,0,1,1,0,0,-1,0,1,-1,0,1,0,0,-1,1,0,0,1,-1,0,0,-1,-1,0,0,1,-1,0,0,-1,-1,0,0,1,0,-1
