1,1,1,1,1,1,1,0,0,1,0,1,0,0,0,0,0,0,0,1
1,0,2,0,2,0,0,0,1,0,0,0,0,0,2,0,0,0,0,0
1,2,1,1,1,1,0,0,0,0,0,0,0,0,0,0,0,0,1,1
1,0,1,0,0,0,0,0,0,0,0,0,0,0,0,0,0,0,1,0
1,2,1,1,1,0,0,1,0,0,0,0,0,0,0,0,1,3,1,1
1,0,1,0,0,0,0,0,0,0,0,0,0,0,0,0,1,0,0,1
0,1,0,0,0,0,0,0,0,0,3,0,0,0,0,2,0,0,0,1
1,1,0,0,0,0,0,1,1,1,1,1,0,0,1,1,1,1,0,1
1,2,0,0,0,2,2,2,2,2,2,2,0,0,0,0,2,1,0,1
1,1,1,1,1,1,1,1,0,0,0,0,0,0,1,4,1,1,0,1
1,4,0,0,0,2,2,2,2,2,2,2,0,0,1,0,0,0,0,1
1,1,1,1,1,1,1,1,1,1,1,1,1,1,1,1,1,1,1,1
10,16
vache=9,8,10,8,10,1,10,8
