0,0,0,0,0,0,0,0,0,0,0,0,0,0,0,0,0,0,0,0
0,0,0,1,0,0,0,0,1,1,3,0,0,0,0,1,0,0,0,0
0,0,1,1,0,0,0,1,0,0,0,1,0,0,0,1,1,0,0,0
0,0,0,0,0,0,1,0,0,0,0,0,1,0,1,0,0,0,0,0
0,0,0,0,0,1,1,0,1,0,1,0,1,1,0,0,0,0,0,0
0,0,0,0,0,0,1,0,0,0,0,0,3,0,0,0,0,0,0,0
0,0,0,0,0,0,1,0,2,2,2,0,1,0,0,0,0,0,0,0
0,0,0,0,0,0,1,3,0,0,0,1,1,0,0,0,0,0,0,0
0,0,0,0,0,3,0,0,1,1,1,0,0,1,0,0,0,0,0,0
0,0,0,1,1,0,0,0,0,0,0,0,0,0,1,1,0,0,0,0
0,0,0,0,1,0,0,0,0,0,0,0,0,0,1,0,0,0,0,0
0,0,0,0,0,0,0,0,0,0,0,0,0,0,0,0,0,0,0,0
0,19
vache=0,0,0,9,0,7,1,7,1,4,5,4,5,3,7,3,7,0
vache=2,10,3,10,3,11,4,11,3,11,3,10
chat=5,16,5,19,11,19,11,13,11,16
chat=3,7,3,9,5,9,5,11,5,7
